11111111
1000C001
1000C001
10P00E01
11111111