111111
100E01
111101
1PC001
111111