1111111111
11CECCCC11
1111C1C1C1
1PCCCCCCC1
1111C11111
1111C11111
1111CCCCC1
1111111111