1111111111
110E000011
11110101C1
1PC0000001
1111011111
1111011111
11110000C1
1111111111