1111111111111111111
11CE000011111111111
1111C10101111111111
1P00000000000000001
1111011111111111111
1111011111111111111
1111000001111111111
1111111111111111111