111111
110E01
111101
1PC001
111111