111111
1E0001
111111
1PC111
111111
